# Mapfile. Created by GNU ddrescue version 1.28
# Command line: ddrescue -n -b2048 -v /dev/sr0 cdimage mapfile
# Start time:   2024-12-08 21:27:48
# Current time: 2024-12-08 21:28:56
# Copying non-tried blocks... Pass 5 (forwards)
# current_pos  current_status  current_pass
0x264A0000     ?               5
#      pos        size  status
0x00000000  0x26241000  +
0x26241000  0x0000F000  *
0x26250000  0x00048000  +
0x26298000  0x00008000  *
0x262A0000  0x001E0000  +
0x26480000  0x00010000  *
0x26490000  0x00001000  +
0x26491000  0x0000F000  *
0x264A0000  0x173710000  ?
0x199BB0000  0x00060000  *
0x199C10000  0x00001000  +
0x199C11000  0x0000F000  *
0x199C20000  0x00001000  +
0x199C21000  0x0000F000  *
0x199C30000  0x00001000  +
0x199C31000  0x0000F000  *
0x199C40000  0x00002000  +
0x199C42000  0x0000E000  *
0x199C50000  0x00002000  +
0x199C52000  0x0000E000  *
0x199C60000  0x00003000  +
0x199C63000  0x0000D000  *
0x199C70000  0x00003000  +
0x199C73000  0x0000D000  *
0x199C80000  0x00004000  +
0x199C84000  0x0000C000  *
0x199C90000  0x00004000  +
0x199C94000  0x0000C000  *
0x199CA0000  0x00005000  +
0x199CA5000  0x0001B000  *
0x199CC0000  0x00005000  +
0x199CC5000  0x0000B000  *
0x199CD0000  0x00006000  +
0x199CD6000  0x0019A000  *
0x199E70000  0x00001000  +
0x199E71000  0x0004F000  *
0x199EC0000  0x00003000  +
0x199EC3000  0x0000D000  *
0x199ED0000  0x00003000  +
0x199ED3000  0x0000D000  *
0x199EE0000  0x00004000  +
0x199EE4000  0x001EC000  *
0x19A0D0000  0x00001000  +
0x19A0D1000  0x0000F000  *
0x19A0E0000  0x00001000  +
0x19A0E1000  0x0001F000  *
0x19A100000  0x00002000  +
0x19A102000  0x0001E000  *
0x19A120000  0x00003000  +
0x19A123000  0x0004D000  *
0x19A170000  0x00005000  +
0x19A175000  0x0004B000  *
0x19A1C0000  0x00007000  +
0x19A1C7000  0x001B9000  *
0x19A380000  0x00002000  +
0x19A382000  0x0000E000  *
0x19A390000  0x00002000  +
0x19A392000  0x0002E000  *
0x19A3C0000  0x00004000  +
0x19A3C4000  0x0000C000  *
0x19A3D0000  0x00004000  +
0x19A3D4000  0x0003C000  *
0x19A410000  0x00006000  +
0x19A416000  0x0002A000  *
0x19A440000  0x00007000  +
0x19A447000  0x00029000  *
0x19A470000  0x00008000  +
0x19A478000  0x00058000  *
0x19A4D0000  0x0000A000  +
0x19A4DA000  0x000E6000  *
0x19A5C0000  0x1BD48000  +
